100
10
1111111111111111111111111111111111111111111111111111111111111111111111111111111111111111111111111111
1000000000000000000000000000000000000000000000000000000000000000000000000000000000000000000000011111
1000000000000000000000000000000000000000000000000000000000000000000000000000000000000000000000011111
1000000000000000000000000000000000000000000000000011100111000000000000000000000000000000000000011111
1000000000000000000000000000000000000000000000111000000000000000000000000000000000000000000000011111
1000000000000000000000000000000000000000001110000000000000000000000000000000000000000000000000001111
1000000101010000000001110000000000000011100000000000000000000000000000000000000000000000000000000001
1000110000000001011100000111001000001000000000000000000000000000000000000000110110110100000000000001
1010111000000101000000000000000010100000000000000000000000000000000000001110000000000001000001010111
1110111000000000000000000000000000000000000000000000000000000100101010100000000000000000011100000111